6,6,6,6,6,6,6,6,6,6,6,6,6,6,6,6,6,6,6,6,6,6,6,6,6,6,6,6,6,6,6,6,6,6,6,6,6,6,6,6,
6,0,0,0,0,0,0,0,0,0,0,0,0,0,6,6,6,6,6,0,0,0,0,0,0,0,0,0,0,0,0,0,0,0,0,0,0,0,0,9,
6,0,3,0,0,0,0,0,0,0,0,0,0,0,6,6,6,6,6,0,0,0,0,0,0,0,0,0,0,0,0,0,0,0,0,0,0,0,0,9,
6,0,0,0,0,0,0,0,0,0,0,0,0,0,6,6,6,6,6,0,0,0,0,0,0,0,0,0,0,0,0,0,0,0,0,0,0,0,0,9,
6,0,0,0,0,0,0,0,0,0,0,0,0,0,6,6,6,6,6,0,0,0,0,0,0,0,0,0,0,0,0,0,0,0,0,0,0,0,0,9,
6,0,0,0,0,0,0,0,0,0,0,0,0,0,6,6,6,6,6,0,0,0,0,0,0,0,0,0,0,0,0,0,0,0,0,0,0,0,0,9,
6,6,6,6,6,6,6,6,0,0,0,0,0,0,6,6,6,6,6,0,0,0,0,0,0,0,0,6,6,6,6,6,6,6,6,6,6,6,6,6,
6,6,6,6,6,6,6,6,0,0,0,0,0,0,6,6,6,6,6,0,0,0,0,0,0,0,0,6,6,6,5,0,5,0,5,6,6,6,6,6,
6,6,6,6,6,6,6,6,0,0,0,0,0,0,6,6,6,6,6,0,0,0,0,0,0,0,0,10,10,10,0,0,0,0,0,10,10,10,10,6,
6,6,6,6,6,6,6,6,0,0,0,0,0,0,6,6,6,6,6,0,0,0,0,0,0,0,0,10,10,10,0,0,0,0,0,6,10,10,10,6,
6,6,6,6,6,6,6,6,0,0,0,0,0,0,6,6,6,6,6,0,0,7,7,7,7,7,7,6,6,6,0,0,0,0,0,6,10,10,10,6,
6,6,6,6,6,6,6,6,0,0,0,0,0,0,0,0,0,0,0,0,0,7,7,7,7,7,7,6,6,6,0,0,0,0,0,6,10,10,10,6,
6,6,6,6,6,6,6,6,0,0,0,0,0,0,0,0,0,0,0,0,0,7,7,7,7,7,7,6,6,6,0,0,0,0,0,6,10,10,10,6,
6,6,6,6,6,6,6,6,0,0,0,0,0,0,0,0,0,0,0,0,0,7,7,7,7,7,7,6,6,6,0,0,0,0,0,6,10,10,10,6,
6,6,6,6,6,6,6,6,0,0,0,0,0,0,0,0,0,0,0,0,0,7,7,7,7,7,7,6,6,6,0,0,0,0,0,6,10,10,10,6,
6,6,6,6,6,6,6,6,0,0,0,0,0,0,0,0,0,0,0,0,0,7,7,7,7,7,7,6,6,6,0,0,0,0,0,6,10,10,10,6,
6,6,6,6,6,6,6,6,1,1,1,1,1,1,1,1,0,0,0,0,0,7,7,7,7,7,7,6,6,6,0,0,0,0,0,6,10,10,10,6,
6,6,6,6,6,6,6,6,6,6,6,6,6,6,6,6,6,6,6,6,6,6,6,6,6,6,6,6,6,6,0,14,0,14,0,10,10,10,10,6,
6,6,6,6,6,6,6,6,6,6,6,6,6,6,6,6,6,6,6,6,6,6,6,6,6,6,6,6,6,6,5,0,5,0,5,10,10,10,10,6,
6,6,6,6,6,6,6,6,6,6,6,6,6,6,6,6,6,6,6,6,6,6,6,6,6,6,6,6,6,6,6,6,6,6,6,6,6,6,6,6
