6,6,6,6,6,6,6,6,6,6,6,6,6,6,6,6,6,6,6,6,6,6,6,6,6,6,6,6,6,6,6,6,6,6,6,6,6,6,6,6,
6,0,0,0,0,0,0,0,0,0,0,0,0,0,6,6,6,6,6,0,0,0,0,0,0,0,0,0,0,0,0,0,0,0,0,0,0,0,0,9,
6,0,0,0,0,0,0,0,0,0,0,0,0,0,6,6,6,6,6,0,0,0,0,0,0,0,0,0,0,0,0,0,0,0,0,0,0,0,0,9,
6,0,0,0,0,0,0,0,0,0,0,0,0,0,6,6,6,6,6,0,0,0,0,0,0,0,0,0,0,0,0,0,0,0,0,0,0,0,0,9,
6,0,0,0,0,0,0,0,0,0,0,0,0,0,6,6,6,6,6,0,0,0,0,0,0,0,0,0,0,0,0,0,0,0,0,0,0,0,0,9,
6,0,0,0,0,0,0,0,0,0,0,0,0,0,6,6,6,6,6,0,0,0,0,0,0,0,0,0,0,0,0,0,0,0,0,0,0,0,0,9,
6,6,6,6,6,6,6,6,0,0,0,0,0,0,6,6,6,6,6,0,0,0,0,0,0,0,0,6,6,6,6,6,6,6,6,6,6,6,6,6,
6,6,6,6,6,6,6,6,0,0,0,0,0,0,6,6,6,6,6,0,0,0,0,0,0,0,0,6,6,6,6,6,6,6,6,6,6,6,6,6,
6,6,6,6,6,6,6,6,0,0,0,0,0,0,6,6,6,6,6,0,0,0,0,0,0,0,0,6,6,6,6,6,6,6,6,6,6,6,6,6,
6,6,6,6,6,6,6,6,0,0,0,0,0,0,6,6,6,6,6,0,0,0,0,0,0,0,0,6,6,6,6,6,6,6,6,6,6,6,6,6,
6,6,6,6,6,6,6,6,0,0,0,0,0,0,6,6,6,6,6,0,0,7,7,7,7,7,7,6,6,6,6,6,6,6,6,6,6,6,6,6,
6,6,6,6,6,6,6,6,0,0,0,0,0,0,0,0,0,0,0,0,0,7,7,7,7,7,7,6,6,6,6,6,6,6,6,6,6,6,6,6,
6,6,6,6,6,6,6,6,0,0,0,0,0,0,0,0,0,0,0,0,0,7,7,7,7,7,7,6,6,6,6,6,6,6,6,6,6,6,6,6,
6,6,6,6,6,6,6,6,0,0,0,0,0,0,0,0,0,0,0,0,0,7,7,7,7,7,7,6,6,6,6,6,6,6,6,6,6,6,6,6,
6,6,6,6,6,6,6,6,0,0,0,0,0,0,0,0,0,0,0,0,0,7,7,7,7,7,7,6,6,6,6,6,6,6,6,6,6,6,6,6,
6,6,6,6,6,6,6,6,0,0,0,0,0,0,0,0,0,0,0,0,0,7,7,7,7,7,7,6,6,6,6,6,6,6,6,6,6,6,6,6,
6,6,6,6,6,6,6,6,1,1,1,1,1,1,1,1,0,0,0,0,0,7,7,7,7,7,7,6,6,6,6,6,6,6,6,6,6,6,6,6,
6,6,6,6,6,6,6,6,6,6,6,6,6,6,6,6,6,6,6,6,6,6,6,6,6,6,6,6,6,6,6,6,6,6,6,6,6,6,6,6,
6,6,6,6,6,6,6,6,6,6,6,6,6,6,6,6,6,6,6,6,6,6,6,6,6,6,6,6,6,6,6,6,6,6,6,6,6,6,6,6,
6,6,6,6,6,6,6,6,6,6,6,6,6,6,6,6,6,6,6,6,6,6,6,6,6,6,6,6,6,6,6,6,6,6,6,6,6,6,6,6
