6,6,6,6,6,6,6,6,6,6,6,6,6,6,6,6,6,6,6,6,6,6,6,6,6,6,6,6,6,6,6,6,6,6,6,6,6,6,6,6,
6,0,0,0,0,0,0,0,0,0,0,0,0,0,0,0,0,0,0,0,0,0,0,0,0,0,12,6,11,0,0,0,0,0,0,0,0,0,0,6,
6,0,0,0,0,0,0,0,0,0,0,0,0,0,5,0,0,0,0,0,0,0,0,0,0,0,12,6,11,0,0,0,0,0,0,0,0,3,0,6,
6,0,0,0,0,0,0,0,0,0,0,0,0,0,0,0,0,0,0,0,0,0,0,0,0,0,12,6,11,0,0,0,0,0,0,0,0,0,0,6,
6,0,0,0,0,0,0,0,0,0,0,0,0,0,0,0,0,0,0,0,5,0,0,0,0,0,12,6,11,0,0,0,0,0,0,0,0,0,0,6,
6,0,0,0,0,0,0,0,0,15,0,0,0,0,1,0,0,0,0,0,0,0,0,0,0,0,12,6,11,0,0,0,0,0,5,0,0,0,0,6,
6,0,0,0,0,0,0,0,0,0,0,0,0,12,6,11,0,0,0,0,0,0,0,15,0,0,12,6,11,0,0,0,0,0,0,0,0,0,0,6,
6,0,0,0,0,0,0,0,0,0,0,0,0,12,6,11,0,0,0,0,5,0,0,0,0,0,12,6,11,0,0,0,0,0,0,0,0,0,0,6,
6,0,0,0,0,0,0,0,0,0,0,0,0,12,6,11,0,0,0,0,0,0,0,0,0,0,12,6,11,0,0,0,0,0,5,0,0,0,0,6,
6,0,0,9,0,0,0,0,0,0,0,0,0,12,6,11,0,0,0,0,0,0,0,0,0,0,12,6,11,0,0,0,0,0,0,0,0,0,0,6,
6,0,0,0,0,0,0,0,0,0,0,0,0,12,6,11,0,0,0,0,5,0,0,0,0,0,12,6,11,0,0,0,0,0,0,0,0,0,0,6,
6,0,0,0,0,0,0,0,0,0,0,0,0,12,6,11,0,0,0,0,0,0,0,0,0,0,12,6,11,0,0,0,0,0,5,0,0,0,0,6,
6,0,0,0,0,0,0,0,0,0,0,0,0,12,6,11,0,0,0,0,0,0,0,0,0,0,12,6,11,0,0,0,0,0,0,0,0,0,0,6,
6,0,0,0,0,0,0,0,0,0,0,0,0,12,6,11,0,0,0,0,5,0,0,0,0,0,12,6,11,0,0,15,0,0,0,0,0,0,0,6,
6,0,0,0,0,0,0,0,0,0,0,0,0,12,6,11,0,0,0,0,0,0,0,0,0,0,0,0,0,0,0,0,0,0,5,0,0,0,0,6,
6,0,0,0,0,0,0,0,0,0,0,0,0,12,6,11,0,0,0,0,0,0,0,0,0,0,0,0,0,0,0,0,0,0,0,0,0,0,0,6,
6,0,0,0,0,0,0,0,0,0,0,0,0,12,6,11,0,0,0,0,5,0,0,0,0,0,0,0,0,0,0,0,0,0,0,0,0,16,0,6,
6,0,0,0,0,0,0,0,0,0,0,0,0,12,6,11,0,0,0,0,0,0,5,0,5,0,5,0,5,0,5,0,5,0,5,0,0,0,0,6,
6,0,0,0,0,0,0,0,0,0,0,0,0,12,6,11,0,0,0,0,0,0,0,0,0,0,0,0,0,0,0,0,0,0,0,0,0,0,0,6,
6,6,6,6,6,6,6,6,6,6,6,6,6,6,6,6,6,6,6,6,6,6,6,6,6,6,6,6,6,6,6,6,6,6,6,6,6,6,6,6
